a -> ?
aa -> ?
ab -> TargetHUD
ac -> AutoPlace
ad -> Setting
ae -> Teleport
af -> Duel Stats
ag -> Timer
ah -> ?
ai -> ?
aj -> Bedwar Helper
am -> ?
an -> ?
ao -> Auth?
ap -> Scaffold2
aq -> Quakecraft
as -> BreakProgress
at -> AutoClicker
au -> Command Line
av -> Bhop
aw -> TPAura
ax -> Slyport
ay -> AntiBot
az -> ?
b -> Bridge Info
ba -> Tracers
bb -> ?
bc -> KeyStrokMod
bd -> RotationUtils
be ->
bf -> AntiShuffle
bg -> Fake Chat
bh -> ?
bi -> ?
bj -> ?
bk -> Name Hider
bq -> FastPlace
bs -> AntiKnockback
bu -> HypixelUtils
bx -> Reach
by -> ChestESP
bz -> Speed
c -> StopMotion
ca -> ?
cb -> Shaders
cc -> BlockPosUtils?
cd -> ?
ce -> NoSlow
cg -> Murder Mystery
ch -> HUD
ci -> ?
cj -> Gui
ck -> Config
cm -> Nametags
cn -> URLUtils
co -> AutoJump
cp -> Latency Alerts
cq -> ?
cr -> Delay Remover
cs -> ?
cu -> ?
cw -> Anticheat
cx -> ?
cy -> BedAura
cz -> RenderUtils
fb -> ModuleManager
fe -> SliderSetting
et -> BoolValue
ge -> Module
hs -> Settings
